15 20
4 12 10 6 10 6 12 12 12 12 14 10 6 10 6 14 8 6 12 10
6 8 3 3 5 13 12 8 6 12 9 3 1 5 9 5 10 3 6 9
7 10 3 3 6 12 12 12 9 2 6 9 6 12 12 10 5 9 7 10
3 3 3 3 3 6 10 6 10 5 13 10 7 10 6 9 6 10 3 3
3 5 9 3 5 9 5 9 5 12 10 3 3 3 5 12 9 3 3 3
3 2 6 9 6 12 12 12 12 12 9 3 3 3 4 14 10 3 1 3
3 5 13 8 3 2 6 12 12 14 10 3 1 3 6 9 1 5 10 3
5 10 6 12 9 3 3 6 8 3 1 3 6 9 3 6 12 12 9 3
6 9 3 6 12 13 9 5 10 3 6 9 5 10 5 13 12 10 6 9
5 10 3 5 10 4 14 12 11 3 5 12 10 5 10 6 12 9 7 10
2 3 5 10 3 6 9 6 9 7 12 8 5 12 9 3 2 6 9 3
3 3 6 9 5 9 2 5 10 5 12 12 12 10 6 9 5 13 8 3
3 5 9 6 12 12 15 8 3 4 12 14 8 3 3 4 14 12 12 11
7 12 8 7 10 4 9 6 9 6 12 11 6 9 5 10 3 2 6 9
5 12 12 9 5 12 12 13 12 9 4 9 5 12 12 13 9 5 13 8
